Difficulty: medium, Algorithm: A* (Manhattan)
Solution found in 34 moves, in 16.8689 s
Nodes expanded: 117774, Max frontier: 42341
 Full solution path:
    # # # # # # # #
    # # #       # #
    # .   @ *   # #
    # # #   * . # #
    # . # # *   # #
    #   #   .   # #
    # *   * * * . #
    #       .     #
    # # # # # # # #

  Move 1: up
    # # # # # # # #
    # # # @     # #
    # .     *   # #
    # # #   * . # #
    # . # # *   # #
    #   #   .   # #
    # *   * * * . #
    #       .     #
    # # # # # # # #

  Move 2: right
    # # # # # # # #
    # # #   @   # #
    # .     *   # #
    # # #   * . # #
    # . # # *   # #
    #   #   .   # #
    # *   * * * . #
    #       .     #
    # # # # # # # #

  Move 3: right
    # # # # # # # #
    # # #     @ # #
    # .     *   # #
    # # #   * . # #
    # . # # *   # #
    #   #   .   # #
    # *   * * * . #
    #       .     #
    # # # # # # # #

  Move 4: down
    # # # # # # # #
    # # #       # #
    # .     * @ # #
    # # #   * . # #
    # . # # *   # #
    #   #   .   # #
    # *   * * * . #
    #       .     #
    # # # # # # # #

  Move 5: down
    # # # # # # # #
    # # #       # #
    # .     *   # #
    # # #   * @ # #
    # . # # *   # #
    #   #   .   # #
    # *   * * * . #
    #       .     #
    # # # # # # # #

  Move 6: down
    # # # # # # # #
    # # #       # #
    # .     *   # #
    # # #   * . # #
    # . # # * @ # #
    #   #   .   # #
    # *   * * * . #
    #       .     #
    # # # # # # # #

  Move 7: down
    # # # # # # # #
    # # #       # #
    # .     *   # #
    # # #   * . # #
    # . # # *   # #
    #   #   . @ # #
    # *   * * * . #
    #       .     #
    # # # # # # # #

  Move 8: left
    # # # # # # # #
    # # #       # #
    # .     *   # #
    # # #   * . # #
    # . # # *   # #
    #   #   @   # #
    # *   * * * . #
    #       .     #
    # # # # # # # #

  Move 9: left
    # # # # # # # #
    # # #       # #
    # .     *   # #
    # # #   * . # #
    # . # # *   # #
    #   # @ .   # #
    # *   * * * . #
    #       .     #
    # # # # # # # #

  Move 10: down
    # # # # # # # #
    # # #       # #
    # .     *   # #
    # # #   * . # #
    # . # # *   # #
    #   #   .   # #
    # *   @ * * . #
    #     * .     #
    # # # # # # # #

  Move 11: left
    # # # # # # # #
    # # #       # #
    # .     *   # #
    # # #   * . # #
    # . # # *   # #
    #   #   .   # #
    # * @   * * . #
    #     * .     #
    # # # # # # # #

  Move 12: down
    # # # # # # # #
    # # #       # #
    # .     *   # #
    # # #   * . # #
    # . # # *   # #
    #   #   .   # #
    # *     * * . #
    #   @ * .     #
    # # # # # # # #

  Move 13: left
    # # # # # # # #
    # # #       # #
    # .     *   # #
    # # #   * . # #
    # . # # *   # #
    #   #   .   # #
    # *     * * . #
    # @   * .     #
    # # # # # # # #

  Move 14: up
    # # # # # # # #
    # # #       # #
    # .     *   # #
    # # #   * . # #
    # . # # *   # #
    # * #   .   # #
    # @     * * . #
    #     * .     #
    # # # # # # # #

  Move 15: up
    # # # # # # # #
    # # #       # #
    # .     *   # #
    # # #   * . # #
    # * # # *   # #
    # @ #   .   # #
    #       * * . #
    #     * .     #
    # # # # # # # #

  Move 16: down
    # # # # # # # #
    # # #       # #
    # .     *   # #
    # # #   * . # #
    # * # # *   # #
    #   #   .   # #
    # @     * * . #
    #     * .     #
    # # # # # # # #

  Move 17: right
    # # # # # # # #
    # # #       # #
    # .     *   # #
    # # #   * . # #
    # * # # *   # #
    #   #   .   # #
    #   @   * * . #
    #     * .     #
    # # # # # # # #

  Move 18: right
    # # # # # # # #
    # # #       # #
    # .     *   # #
    # # #   * . # #
    # * # # *   # #
    #   #   .   # #
    #     @ * * . #
    #     * .     #
    # # # # # # # #

  Move 19: up
    # # # # # # # #
    # # #       # #
    # .     *   # #
    # # #   * . # #
    # * # # *   # #
    #   # @ .   # #
    #       * * . #
    #     * .     #
    # # # # # # # #

  Move 20: right
    # # # # # # # #
    # # #       # #
    # .     *   # #
    # # #   * . # #
    # * # # *   # #
    #   #   @   # #
    #       * * . #
    #     * .     #
    # # # # # # # #

  Move 21: down
    # # # # # # # #
    # # #       # #
    # .     *   # #
    # # #   * . # #
    # * # # *   # #
    #   #   .   # #
    #       @ * . #
    #     * *     #
    # # # # # # # #

  Move 22: right
    # # # # # # # #
    # # #       # #
    # .     *   # #
    # # #   * . # #
    # * # # *   # #
    #   #   .   # #
    #         @ * #
    #     * *     #
    # # # # # # # #

  Move 23: up
    # # # # # # # #
    # # #       # #
    # .     *   # #
    # # #   * . # #
    # * # # *   # #
    #   #   . @ # #
    #           * #
    #     * *     #
    # # # # # # # #

  Move 24: up
    # # # # # # # #
    # # #       # #
    # .     *   # #
    # # #   * . # #
    # * # # * @ # #
    #   #   .   # #
    #           * #
    #     * *     #
    # # # # # # # #

  Move 25: up
    # # # # # # # #
    # # #       # #
    # .     *   # #
    # # #   * @ # #
    # * # # *   # #
    #   #   .   # #
    #           * #
    #     * *     #
    # # # # # # # #

  Move 26: up
    # # # # # # # #
    # # #       # #
    # .     * @ # #
    # # #   * . # #
    # * # # *   # #
    #   #   .   # #
    #           * #
    #     * *     #
    # # # # # # # #

  Move 27: left
    # # # # # # # #
    # # #       # #
    # .   * @   # #
    # # #   * . # #
    # * # # *   # #
    #   #   .   # #
    #           * #
    #     * *     #
    # # # # # # # #

  Move 28: left
    # # # # # # # #
    # # #       # #
    # . * @     # #
    # # #   * . # #
    # * # # *   # #
    #   #   .   # #
    #           * #
    #     * *     #
    # # # # # # # #

  Move 29: left
    # # # # # # # #
    # # #       # #
    # * @       # #
    # # #   * . # #
    # * # # *   # #
    #   #   .   # #
    #           * #
    #     * *     #
    # # # # # # # #

  Move 30: right
    # # # # # # # #
    # # #       # #
    # *   @     # #
    # # #   * . # #
    # * # # *   # #
    #   #   .   # #
    #           * #
    #     * *     #
    # # # # # # # #

  Move 31: down
    # # # # # # # #
    # # #       # #
    # *         # #
    # # # @ * . # #
    # * # # *   # #
    #   #   .   # #
    #           * #
    #     * *     #
    # # # # # # # #

  Move 32: right
    # # # # # # # #
    # # #       # #
    # *         # #
    # # #   @ * # #
    # * # # *   # #
    #   #   .   # #
    #           * #
    #     * *     #
    # # # # # # # #

  Move 33: down
    # # # # # # # #
    # # #       # #
    # *         # #
    # # #     * # #
    # * # # @   # #
    #   #   *   # #
    #           * #
    #     * *     #
    # # # # # # # #

----------------------------------------
